{
    .cols = 10,
    .rows = 12,
    .data = {
        "1111110000"
        "1100010000"
        "1120010000"
        "0000011000"
        "0001111000"
        "0001111113"
        "0000010000"
        "0000010000"
        "0000010000"
        "1101110000"
        "1101110000"
        "1111100000"
    }
}
