{
    .cols = 7,
    .rows = 7,
    .data = {
        "0111111"
        "0130111"
        "0111100"
        "0111100"
        "1100000"
        "1100000"
        "2000000"
    }
}
