{
    .cols = 6,
    .rows = 13,
    .data = {
        "011100"
        "011100"
        "030100"
        "000100"
        "000100"
        "000111"
        "000101"
        "011100"
        "001100"
        "000100"
        "200100"
        "111100"
        "111100"
    }
}
