{
    .cols = 9,
    .rows = 9,
    .data = {
        "000000111"
        "000000111"
        "000111103"
        "110110000"
        "110110000"
        "111110000"
        "111000000"
        "111000000"
        "001111112"
    }
}
