{
    .cols = 13,
    .rows = 15,
    .data = {
        "0000000000000"
        "0000000300000"
        "0000000100000"
        "0000000100000"
        "0000000111000"
        "0000000011000"
        "0000000011100"
        "0000000001100"
        "0000000001100"
        "0000000001110"
        "0000000000111"
        "0000000020001"
        "0000000011001"
        "0000000011111"
        "0000000000110"
    },
    .switchCount = 1,
    .switches = {
        {.x = 9, .y = 12, .type = LevelSwitchType::SINGLE, .floorX = 9, .floorY = 14}
    }
}
